"filename", "language", "Java", "comment", "blank", "total"
"c:\Jank\src\main\java\jp\co\jastec\jank\Jank.java", "Java", 12, 3, 9, 24
"c:\Jank\src\main\java\jp\co\jastec\jank\base\FixedWidthString.java", "Java", 80, 15, 26, 121
"c:\Jank\src\main\java\jp\co\jastec\jank\base\JankCheckedException.java", "Java", 26, 0, 8, 34
"c:\Jank\src\main\java\jp\co\jastec\jank\base\JankCodeElement.java", "Java", 35, 2, 15, 52
"c:\Jank\src\main\java\jp\co\jastec\jank\base\JankException.java", "Java", 26, 0, 8, 34
"c:\Jank\src\main\java\jp\co\jastec\jank\base\JankList.java", "Java", 28, 4, 9, 41
"c:\Jank\src\main\java\jp\co\jastec\jank\base\JankManHourElement.java", "Java", 8, 3, 7, 18
"c:\Jank\src\main\java\jp\co\jastec\jank\base\JankMessage.java", "Java", 45, 3, 10, 58
"c:\Jank\src\main\java\jp\co\jastec\jank\base\ManHour.java", "Java", 8, 0, 3, 11
"c:\Jank\src\main\java\jp\co\jastec\jank\base\datetime\JankDate.java", "Java", 168, 18, 53, 239
"c:\Jank\src\main\java\jp\co\jastec\jank\base\datetime\JankDateTime.java", "Java", 24, 2, 9, 35
"c:\Jank\src\main\java\jp\co\jastec\jank\base\datetime\JankDateTimeException.java", "Java", 14, 0, 8, 22
"c:\Jank\src\main\java\jp\co\jastec\jank\base\datetime\JankTime.java", "Java", 150, 24, 47, 221
"c:\Jank\src\main\java\jp\co\jastec\jank\base\datetime\JankTimeRange.java", "Java", 65, 3, 24, 92
"c:\Jank\src\main\java\jp\co\jastec\jank\base\datetime\MissingCalendarException.java", "Java", 3, 0, 3, 6
"c:\Jank\src\main\java\jp\co\jastec\jank\base\datetime\calendar\JankCalendar.java", "Java", 88, 11, 26, 125
"c:\Jank\src\main\java\jp\co\jastec\jank\base\datetime\calendar\JankDateCharacteristic.java", "Java", 75, 10, 22, 107
"c:\Jank\src\main\java\jp\co\jastec\jank\base\datetime\calendar\JankHoliday.java", "Java", 52, 1, 18, 71
"c:\Jank\src\main\java\jp\co\jastec\jank\base\datetime\calendar\holidays\EnterpriseHoliday.java", "Java", 35, 3, 13, 51
"c:\Jank\src\main\java\jp\co\jastec\jank\base\datetime\calendar\holidays\EquinoxDay.java", "Java", 82, 3, 18, 103
"c:\Jank\src\main\java\jp\co\jastec\jank\base\datetime\calendar\holidays\NationsDayoff.java", "Java", 49, 4, 11, 64
"c:\Jank\src\main\java\jp\co\jastec\jank\base\datetime\calendar\holidays\PinpointPatch.java", "Java", 41, 2, 9, 52
"c:\Jank\src\main\java\jp\co\jastec\jank\base\datetime\calendar\holidays\PublicNamedHoliday.java", "Java", 48, 2, 26, 76
"c:\Jank\src\main\java\jp\co\jastec\jank\base\datetime\calendar\holidays\SubstitudeHoliday.java", "Java", 57, 7, 14, 78
"c:\Jank\src\main\java\jp\co\jastec\jank\base\datetime\calendar\holidays\VersionableFactory.java", "Java", 101, 8, 26, 135
"c:\Jank\src\main\java\jp\co\jastec\jank\base\validation\JankValidatable.java", "Java", 4, 0, 2, 6
"c:\Jank\src\main\java\jp\co\jastec\jank\base\validation\JankValidatableBase.java", "Java", 9, 0, 5, 14
"c:\Jank\src\main\java\jp\co\jastec\jank\base\validation\JankValidator.java", "Java", 33, 14, 16, 63
"c:\Jank\src\main\java\jp\co\jastec\jank\base\validation\ResultList.java", "Java", 6, 3, 4, 13
"c:\Jank\src\main\java\jp\co\jastec\jank\base\validation\StringFormatChecker.java", "Java", 104, 4, 30, 138
"c:\Jank\src\main\java\jp\co\jastec\jank\cli\CliView.java", "Java", 43, 0, 16, 59
"c:\Jank\src\main\java\jp\co\jastec\jank\cli\InputRejectException.java", "Java", 22, 0, 7, 29
"c:\Jank\src\main\java\jp\co\jastec\jank\cli\Interactive.java", "Java", 21, 0, 14, 35
"c:\Jank\src\main\java\jp\co\jastec\jank\cli\InteractiveInput.java", "Java", 93, 16, 34, 143
"c:\Jank\src\main\java\jp\co\jastec\jank\cli\InteractiveLoop.java", "Java", 82, 2, 33, 117
"c:\Jank\src\main\java\jp\co\jastec\jank\cli\InteractiveSelect.java", "Java", 67, 4, 30, 101
"c:\Jank\src\main\java\jp\co\jastec\jank\cli\JankConsole.java", "Java", 81, 2, 24, 107
"c:\Jank\src\main\java\jp\co\jastec\jank\cli\ModelViewer.java", "Java", 27, 0, 11, 38
"c:\Jank\src\main\java\jp\co\jastec\jank\cli\Option.java", "Java", 26, 5, 11, 42
"c:\Jank\src\main\java\jp\co\jastec\jank\cli\OptionSelecter.java", "Java", 50, 3, 18, 71
"c:\Jank\src\main\java\jp\co\jastec\jank\input\AbsenceTimeInput.java", "Java", 129, 2, 38, 169
"c:\Jank\src\main\java\jp\co\jastec\jank\input\Closing.java", "Java", 44, 1, 12, 57
"c:\Jank\src\main\java\jp\co\jastec\jank\input\DateInput.java", "Java", 45, 0, 10, 55
"c:\Jank\src\main\java\jp\co\jastec\jank\input\DayOffInput.java", "Java", 46, 0, 12, 58
"c:\Jank\src\main\java\jp\co\jastec\jank\input\DetailOneLineInput.java", "Java", 130, 11, 43, 184
"c:\Jank\src\main\java\jp\co\jastec\jank\input\EmpNoInput.java", "Java", 36, 0, 15, 51
"c:\Jank\src\main\java\jp\co\jastec\jank\input\HalfDayOffInput.java", "Java", 52, 0, 15, 67
"c:\Jank\src\main\java\jp\co\jastec\jank\input\Opening.java", "Java", 32, 1, 11, 44
"c:\Jank\src\main\java\jp\co\jastec\jank\input\PracticeSelect.java", "Java", 53, 0, 14, 67
"c:\Jank\src\main\java\jp\co\jastec\jank\input\ProjectSelect.java", "Java", 62, 0, 15, 77
"c:\Jank\src\main\java\jp\co\jastec\jank\input\RestCheckSelect.java", "Java", 48, 0, 18, 66
"c:\Jank\src\main\java\jp\co\jastec\jank\input\StartDetailInput.java", "Java", 31, 1, 10, 42
"c:\Jank\src\main\java\jp\co\jastec\jank\input\TaskHourInput.java", "Java", 105, 0, 25, 130
"c:\Jank\src\main\java\jp\co\jastec\jank\input\TimeInput.java", "Java", 60, 0, 17, 77
"c:\Jank\src\main\java\jp\co\jastec\jank\input\WorkingPatternInput.java", "Java", 42, 1, 14, 57
"c:\Jank\src\main\java\jp\co\jastec\jank\model\JankModel.java", "Java", 65, 0, 22, 87
"c:\Jank\src\main\java\jp\co\jastec\jank\model\detail\DetailContainer.java", "Java", 134, 4, 39, 177
"c:\Jank\src\main\java\jp\co\jastec\jank\model\detail\GenericProject.java", "Java", 16, 3, 8, 27
"c:\Jank\src\main\java\jp\co\jastec\jank\model\detail\Practice.java", "Java", 47, 1, 17, 65
"c:\Jank\src\main\java\jp\co\jastec\jank\model\detail\Productive.java", "Java", 38, 0, 15, 53
"c:\Jank\src\main\java\jp\co\jastec\jank\model\detail\Project.java", "Java", 35, 1, 10, 46
"c:\Jank\src\main\java\jp\co\jastec\jank\model\detail\ProjectWithProductive.java", "Java", 19, 1, 8, 28
"c:\Jank\src\main\java\jp\co\jastec\jank\model\detail\ProjectWithTask.java", "Java", 19, 1, 10, 30
"c:\Jank\src\main\java\jp\co\jastec\jank\model\detail\ProjectWithoutTasks.java", "Java", 28, 1, 9, 38
"c:\Jank\src\main\java\jp\co\jastec\jank\model\detail\Task.java", "Java", 44, 3, 12, 59
"c:\Jank\src\main\java\jp\co\jastec\jank\model\header\AbsenceTime.java", "Java", 188, 12, 56, 256
"c:\Jank\src\main\java\jp\co\jastec\jank\model\header\DayOffType.java", "Java", 36, 1, 10, 47
"c:\Jank\src\main\java\jp\co\jastec\jank\model\header\Employee.java", "Java", 43, 2, 12, 57
"c:\Jank\src\main\java\jp\co\jastec\jank\model\header\RestCheck.java", "Java", 109, 14, 35, 158
"c:\Jank\src\main\java\jp\co\jastec\jank\model\header\WorkingDateTime.java", "Java", 121, 3, 48, 172
"c:\Jank\src\main\java\jp\co\jastec\jank\model\header\WorkingDateTimeValidator.java", "Java", 71, 1, 28, 100
"c:\Jank\src\main\java\jp\co\jastec\jank\model\header\WorkingPattern.java", "Java", 24, 2, 11, 37
"c:\Jank\src\main\java\jp\co\jastec\jank\service\EmpMaster.java", "Java", 30, 3, 12, 45
"c:\Jank\src\main\java\jp\co\jastec\jank\service\JankArchiver.java", "Java", 36, 4, 15, 55
"c:\Jank\src\main\java\jp\co\jastec\jank\service\JankHome.java", "Java", 171, 6, 15, 192
"c:\Jank\src\main\java\jp\co\jastec\jank\service\JankMaster.java", "Java", 31, 8, 15, 54
"c:\Jank\src\main\java\jp\co\jastec\jank\service\PracticeMaster.java", "Java", 30, 4, 13, 47
"c:\Jank\src\main\java\jp\co\jastec\jank\service\ProjectMaster.java", "Java", 57, 3, 18, 78
"c:\Jank\src\main\java\jp\co\jastec\jank\service\TaskSet.java", "Java", 100, 0, 20, 120
"c:\Jank\src\test\java\jp\co\jastec\jank\base\FixedWidthStringTest.java", "Java", 45, 0, 29, 74
"c:\Jank\src\test\java\jp\co\jastec\jank\base\datetime\JankDateTest.java", "Java", 92, 1, 23, 116
"c:\Jank\src\test\java\jp\co\jastec\jank\base\datetime\JankTimeRangeTest.java", "Java", 88, 24, 20, 132
"c:\Jank\src\test\java\jp\co\jastec\jank\base\datetime\JankTimeTest.java", "Java", 104, 2, 32, 138
"Total", "-", 4724, 303, 1508, 6535