"filename", "language", "XML", "Java", "Batch", "YAML", "comment", "blank", "total"
"c:\Jank\.travis.yml", "YAML", 0, 0, 0, 4, 0, 1, 5
"c:\Jank\jank.bat", "Batch", 0, 0, 7, 0, 0, 3, 10
"c:\Jank\pom.xml", "XML", 204, 0, 0, 0, 2, 1, 207
"c:\Jank\src\main\java\jp\co\jastec\jank\Jank.java", "Java", 0, 10, 0, 0, 3, 8, 21
"c:\Jank\src\main\java\jp\co\jastec\jank\base\FixedWidthString.java", "Java", 0, 94, 0, 0, 18, 22, 134
"c:\Jank\src\main\java\jp\co\jastec\jank\base\JankCodeElement.java", "Java", 0, 26, 0, 0, 1, 13, 40
"c:\Jank\src\main\java\jp\co\jastec\jank\base\JankException.java", "Java", 0, 29, 0, 0, 0, 8, 37
"c:\Jank\src\main\java\jp\co\jastec\jank\base\JankList.java", "Java", 0, 34, 0, 0, 6, 10, 50
"c:\Jank\src\main\java\jp\co\jastec\jank\base\JankMessage.java", "Java", 0, 44, 0, 0, 2, 10, 56
"c:\Jank\src\main\java\jp\co\jastec\jank\base\JankReportElement.java", "Java", 0, 13, 0, 0, 3, 7, 23
"c:\Jank\src\main\java\jp\co\jastec\jank\base\ZenAlign.java", "Java", 0, 101, 0, 0, 13, 33, 147
"c:\Jank\src\main\java\jp\co\jastec\jank\base\datetime\DateTimeFormatException.java", "Java", 0, 14, 0, 0, 0, 6, 20
"c:\Jank\src\main\java\jp\co\jastec\jank\base\datetime\DateTimeUtils.java", "Java", 0, 20, 0, 0, 2, 9, 31
"c:\Jank\src\main\java\jp\co\jastec\jank\base\datetime\JankDate.java", "Java", 0, 162, 0, 0, 15, 52, 229
"c:\Jank\src\main\java\jp\co\jastec\jank\base\datetime\JankDateTime.java", "Java", 0, 24, 0, 0, 2, 9, 35
"c:\Jank\src\main\java\jp\co\jastec\jank\base\datetime\JankTime.java", "Java", 0, 160, 0, 0, 16, 49, 225
"c:\Jank\src\main\java\jp\co\jastec\jank\base\datetime\JankTimeRange.java", "Java", 0, 53, 0, 0, 1, 16, 70
"c:\Jank\src\main\java\jp\co\jastec\jank\base\datetime\MissingCalendarException.java", "Java", 0, 3, 0, 0, 0, 3, 6
"c:\Jank\src\main\java\jp\co\jastec\jank\base\datetime\calendar\JankCalendar.java", "Java", 0, 81, 0, 0, 7, 25, 113
"c:\Jank\src\main\java\jp\co\jastec\jank\base\datetime\calendar\JankDateCharacteristic.java", "Java", 0, 75, 0, 0, 10, 22, 107
"c:\Jank\src\main\java\jp\co\jastec\jank\base\datetime\calendar\JankHoliday.java", "Java", 0, 52, 0, 0, 1, 18, 71
"c:\Jank\src\main\java\jp\co\jastec\jank\base\datetime\calendar\holidays\EnterpriseHoliday.java", "Java", 0, 35, 0, 0, 3, 13, 51
"c:\Jank\src\main\java\jp\co\jastec\jank\base\datetime\calendar\holidays\EquinoxDay.java", "Java", 0, 82, 0, 0, 3, 18, 103
"c:\Jank\src\main\java\jp\co\jastec\jank\base\datetime\calendar\holidays\HappyMonday.java", "Java", 0, 38, 0, 0, 3, 15, 56
"c:\Jank\src\main\java\jp\co\jastec\jank\base\datetime\calendar\holidays\NationsDayoff.java", "Java", 0, 49, 0, 0, 4, 11, 64
"c:\Jank\src\main\java\jp\co\jastec\jank\base\datetime\calendar\holidays\PinpointPatch.java", "Java", 0, 41, 0, 0, 2, 9, 52
"c:\Jank\src\main\java\jp\co\jastec\jank\base\datetime\calendar\holidays\PublicNamedHoliday.java", "Java", 0, 48, 0, 0, 2, 26, 76
"c:\Jank\src\main\java\jp\co\jastec\jank\base\datetime\calendar\holidays\StaticHoliday.java", "Java", 0, 57, 0, 0, 4, 23, 84
"c:\Jank\src\main\java\jp\co\jastec\jank\base\datetime\calendar\holidays\SubstitudeHoliday.java", "Java", 0, 58, 0, 0, 7, 14, 79
"c:\Jank\src\main\java\jp\co\jastec\jank\base\datetime\calendar\holidays\VersionableFactory.java", "Java", 0, 100, 0, 0, 8, 25, 133
"c:\Jank\src\main\java\jp\co\jastec\jank\base\validation\JankValidatable.java", "Java", 0, 4, 0, 0, 0, 2, 6
"c:\Jank\src\main\java\jp\co\jastec\jank\base\validation\JankValidatableBase.java", "Java", 0, 8, 0, 0, 0, 5, 13
"c:\Jank\src\main\java\jp\co\jastec\jank\base\validation\JankValidator.java", "Java", 0, 33, 0, 0, 14, 16, 63
"c:\Jank\src\main\java\jp\co\jastec\jank\base\validation\ResultList.java", "Java", 0, 6, 0, 0, 3, 4, 13
"c:\Jank\src\main\java\jp\co\jastec\jank\base\validation\StringFormatChecker.java", "Java", 0, 104, 0, 0, 4, 30, 138
"c:\Jank\src\main\java\jp\co\jastec\jank\cli\CliView.java", "Java", 0, 43, 0, 0, 0, 16, 59
"c:\Jank\src\main\java\jp\co\jastec\jank\cli\InputRejectException.java", "Java", 0, 22, 0, 0, 0, 7, 29
"c:\Jank\src\main\java\jp\co\jastec\jank\cli\Interactive.java", "Java", 0, 21, 0, 0, 0, 13, 34
"c:\Jank\src\main\java\jp\co\jastec\jank\cli\InteractiveInput.java", "Java", 0, 80, 0, 0, 0, 29, 109
"c:\Jank\src\main\java\jp\co\jastec\jank\cli\InteractiveLoop.java", "Java", 0, 56, 0, 0, 2, 26, 84
"c:\Jank\src\main\java\jp\co\jastec\jank\cli\InteractiveSelect.java", "Java", 0, 119, 0, 0, 4, 50, 173
"c:\Jank\src\main\java\jp\co\jastec\jank\cli\JankConsole.java", "Java", 0, 81, 0, 0, 2, 24, 107
"c:\Jank\src\main\java\jp\co\jastec\jank\cli\ModelViewer.java", "Java", 0, 25, 0, 0, 0, 11, 36
"c:\Jank\src\main\java\jp\co\jastec\jank\input\AbsenceTimeInput.java", "Java", 0, 107, 0, 0, 2, 32, 141
"c:\Jank\src\main\java\jp\co\jastec\jank\input\DateInput.java", "Java", 0, 43, 0, 0, 0, 12, 55
"c:\Jank\src\main\java\jp\co\jastec\jank\input\DayOffInput.java", "Java", 0, 46, 0, 0, 0, 15, 61
"c:\Jank\src\main\java\jp\co\jastec\jank\input\DetailInput.java", "Java", 0, 123, 0, 0, 9, 39, 171
"c:\Jank\src\main\java\jp\co\jastec\jank\input\EmpNoInput.java", "Java", 0, 30, 0, 0, 0, 11, 41
"c:\Jank\src\main\java\jp\co\jastec\jank\input\Ending.java", "Java", 0, 37, 0, 0, 3, 10, 50
"c:\Jank\src\main\java\jp\co\jastec\jank\input\HalfDayOffInput.java", "Java", 0, 51, 0, 0, 0, 14, 65
"c:\Jank\src\main\java\jp\co\jastec\jank\input\Opening.java", "Java", 0, 33, 0, 0, 0, 11, 44
"c:\Jank\src\main\java\jp\co\jastec\jank\input\RestCheckInput.java", "Java", 0, 46, 0, 0, 0, 17, 63
"c:\Jank\src\main\java\jp\co\jastec\jank\input\StartDetailInput.java", "Java", 0, 30, 0, 0, 1, 10, 41
"c:\Jank\src\main\java\jp\co\jastec\jank\input\TimeInput.java", "Java", 0, 58, 0, 0, 0, 18, 76
"c:\Jank\src\main\java\jp\co\jastec\jank\input\WorkingPatternInput.java", "Java", 0, 40, 0, 0, 1, 14, 55
"c:\Jank\src\main\java\jp\co\jastec\jank\model\JankModel.java", "Java", 0, 62, 0, 0, 0, 21, 83
"c:\Jank\src\main\java\jp\co\jastec\jank\model\detail\DetailContainer.java", "Java", 0, 110, 0, 0, 4, 35, 149
"c:\Jank\src\main\java\jp\co\jastec\jank\model\detail\GenericProject.java", "Java", 0, 16, 0, 0, 0, 8, 24
"c:\Jank\src\main\java\jp\co\jastec\jank\model\detail\Practice.java", "Java", 0, 45, 0, 0, 1, 17, 63
"c:\Jank\src\main\java\jp\co\jastec\jank\model\detail\Productive.java", "Java", 0, 38, 0, 0, 0, 14, 52
"c:\Jank\src\main\java\jp\co\jastec\jank\model\detail\Project.java", "Java", 0, 35, 0, 0, 0, 10, 45
"c:\Jank\src\main\java\jp\co\jastec\jank\model\detail\ProjectWithProductive.java", "Java", 0, 20, 0, 0, 0, 8, 28
"c:\Jank\src\main\java\jp\co\jastec\jank\model\detail\ProjectWithTask.java", "Java", 0, 20, 0, 0, 0, 10, 30
"c:\Jank\src\main\java\jp\co\jastec\jank\model\detail\ProjectWithoutTasks.java", "Java", 0, 28, 0, 0, 0, 10, 38
"c:\Jank\src\main\java\jp\co\jastec\jank\model\detail\Task.java", "Java", 0, 43, 0, 0, 3, 12, 58
"c:\Jank\src\main\java\jp\co\jastec\jank\model\header\AbsenceTime.java", "Java", 0, 170, 0, 0, 9, 49, 228
"c:\Jank\src\main\java\jp\co\jastec\jank\model\header\DayOffType.java", "Java", 0, 36, 0, 0, 1, 10, 47
"c:\Jank\src\main\java\jp\co\jastec\jank\model\header\Employee.java", "Java", 0, 43, 0, 0, 2, 12, 57
"c:\Jank\src\main\java\jp\co\jastec\jank\model\header\RestCheck.java", "Java", 0, 109, 0, 0, 14, 35, 158
"c:\Jank\src\main\java\jp\co\jastec\jank\model\header\WorkingDateTime.java", "Java", 0, 127, 0, 0, 1, 47, 175
"c:\Jank\src\main\java\jp\co\jastec\jank\model\header\WorkingDateTimeValidator.java", "Java", 0, 71, 0, 0, 1, 28, 100
"c:\Jank\src\main\java\jp\co\jastec\jank\model\header\WorkingPattern.java", "Java", 0, 24, 0, 0, 2, 11, 37
"c:\Jank\src\main\java\jp\co\jastec\jank\service\AbstractService.java", "Java", 0, 3, 0, 0, 0, 3, 6
"c:\Jank\src\main\java\jp\co\jastec\jank\service\CustomerService.java", "Java", 0, 64, 0, 0, 3, 14, 81
"c:\Jank\src\main\java\jp\co\jastec\jank\service\JankArchiver.java", "Java", 0, 36, 0, 0, 3, 15, 54
"c:\Jank\src\main\java\jp\co\jastec\jank\service\JankDao.java", "Java", 0, 3, 0, 0, 0, 3, 6
"c:\Jank\src\main\java\jp\co\jastec\jank\service\JankMaster.java", "Java", 0, 81, 0, 0, 11, 32, 124
"c:\Jank\src\main\java\jp\co\jastec\jank\service\MyPracticeService.java", "Java", 0, 66, 0, 0, 1, 24, 91
"c:\Jank\src\main\java\jp\co\jastec\jank\service\ProjectSercive.java", "Java", 0, 39, 0, 0, 4, 11, 54
"c:\Jank\src\main\java\jp\co\jastec\jank\service\package-info.java", "Java", 0, 1, 0, 0, 4, 0, 5
"Total", "-", 204, 4039, 7, 4, 247, 1354, 5855